WWWWWWWWWWWWWWW
WP            W
W    WW  WW   W
W   WR WW  W  W
W  W   WW Y W W
W  W   Y    W W
W   W   R  W  W
W    W    W   W
W     W  W    W
W      WW     W
W             W
W    G        W
WWWWWWWWWWWWWWW